AD         IIIIIII              IIIIIIIIIIIIIIIIIIIIIIIIIIIIIIIIII
AD                      o o o                 I                  E
AD                     IIIIIII                I                  C
AD                                            I            o o   C
AD                    2   !         2                     IIIII  C
AD                      IIIII                                    C
AD         III                           1    1  1        2      C
AD                            1      IIIIIIIIIIIII               C
AD      1       EBBBBBBBBBBBBBBBF     o o o o o o              * C
AHBBBBBBBBBBBBBBGAAAAAAAAAAAAAAAHBBBBBBBBBBBBBBBBBBBBBBBBBBBBBBBBG
